LDA,0,1,2,3,4,5,6,7,8,9,10,11,12,13,14,15,16,17,18,19,20,21,22,23,24,25,26,27,28,29,30,31,32,33,34,35,36,37,38,39,40,41,42,43,44,45,46,47,48,49,50,51,52,53,54,55,56,57,58,59,60,61,62,63,64,65,66,67,68,69,70,71,72,73,74,75,76,77,78,79,80,81,82,83,84,85,86,87,88,89,90,91,92,93
0,8,7,13,24,11,3,6,2,0,4,2,4,3,3,25,2,2,2,2,7,3,1,0,1,0,0,1,2,0,0,1,1,0,0,0,0,69,1,9,0,0,1,0,1,2,1,1,0,1,0,2,0,0,0,3,6,0,3,0,5,1,0,0,0,2,0,0,1,2,0,0,0,0,1,0,0,1,0,0,1,1,1,0,9,0,0,0,0,0,1,3,2,0,0
1,1,2,1,3,4,1,8,8,0,3,0,10,1,12,2,4,0,2,2,3,0,3,12,2,6,1,3,4,5,0,1,0,0,0,1,1,0,1,3,0,3,0,1,0,2,2,1,1,3,7,1,1,0,0,0,17,0,3,0,0,78,2,1,0,0,1,1,11,4,0,1,0,0,0,13,0,3,0,0,0,1,3,0,1,0,1,0,9,0,1,0,4,0,3
2,4,4,4,4,16,6,3,7,1,3,1,8,1,1,3,1,0,1,1,19,1,2,1,2,1,0,4,3,0,0,0,1,0,0,0,0,0,1,1,0,1,0,39,0,0,0,1,0,1,22,0,2,1,0,0,1,0,18,1,1,0,0,1,0,0,1,1,0,0,0,1,0,0,0,11,0,11,0,0,1,0,1,1,0,0,9,2,16,0,7,0,0,1,3
3,6,1,1,1,1,9,0,1,0,0,17,0,1,0,4,0,2,4,2,1,1,0,0,0,0,0,0,5,2,0,0,1,0,1,1,0,0,0,1,0,0,0,1,1,0,0,0,0,0,0,1,0,0,0,0,0,0,0,0,0,0,0,0,0,0,0,0,0,0,0,1,0,0,0,0,0,0,0,0,0,2,1,0,0,1,0,0,0,0,0,0,0,0,0
4,2,2,1,8,1,1,1,4,1,1,2,4,1,3,3,0,1,1,8,7,1,0,2,2,0,6,1,4,0,0,1,0,0,9,5,1,0,1,0,4,5,10,0,3,0,0,1,3,0,1,2,1,1,0,1,0,0,0,0,2,0,0,0,0,1,2,1,0,1,1,0,0,1,0,1,0,0,2,1,0,1,1,0,0,0,0,0,0,0,0,0,0,0,0
5,0,0,0,0,3,3,2,3,6,1,1,1,0,1,1,1,1,0,3,9,1,0,3,1,1,2,0,38,1,0,1,2,0,1,1,0,0,1,0,0,6,0,0,0,0,0,1,0,1,1,1,0,1,0,0,0,0,0,0,1,0,1,1,0,0,1,2,0,0,0,1,0,0,0,0,0,0,0,1,0,0,1,0,0,0,1,0,0,1,0,0,0,0,0
6,5,1,1,2,15,3,9,1,6,2,0,2,2,1,4,3,1,1,1,7,5,0,0,1,1,5,0,1,1,0,2,0,0,1,0,0,0,0,1,1,13,0,1,1,2,0,0,0,0,1,1,1,0,0,0,0,0,0,0,0,0,0,0,0,1,0,2,0,1,1,1,0,0,0,0,0,1,1,0,1,0,0,0,0,0,0,1,0,0,0,0,1,0,0
7,3,1,4,169,1,1,1,0,1,0,1,2,1,1,6,0,0,0,0,0,0,0,0,0,0,0,0,8,2,0,0,0,0,0,0,0,5,0,0,1,1,0,1,0,0,0,0,0,0,0,0,0,0,0,0,0,1,0,0,0,0,1,0,0,1,0,1,0,0,0,0,0,19,1,0,2,1,0,0,0,0,0,0,0,0,0,1,0,0,0,0,0,0,0
8,9,4,2,6,36,1,7,10,1,0,0,15,1,2,7,4,1,6,6,5,4,0,4,28,0,2,0,9,2,0,4,6,0,0,5,0,1,3,0,2,0,0,0,0,0,3,0,0,0,3,0,0,2,0,1,0,0,1,1,3,0,3,1,3,3,0,2,2,0,2,3,0,0,0,2,0,2,1,9,1,1,1,0,7,0,0,0,1,0,0,1,6,0,1
9,11,2,0,7,5,5,2,16,24,5,1,1,1,9,22,6,2,3,3,23,1,2,3,5,177,2,1,7,2,0,2,2,0,2,2,0,5,4,9,1,9,1,3,1,2,2,3,0,1,3,0,0,2,0,0,0,0,0,0,1,0,0,1,1,0,1,0,1,3,20,0,0,1,0,2,1,0,1,1,0,4,0,0,1,0,0,4,0,0,1,1,3,0,3
10,10,2,2,2,10,13,3,14,1,1,2,2,0,1,1,2,1,4,5,3,6,2,19,1,2,5,3,1,28,0,11,1,0,1,2,0,0,2,1,1,5,1,5,1,2,1,1,0,4,3,12,5,2,0,0,2,1,6,0,3,2,1,2,0,3,0,2,0,0,0,2,0,0,0,5,3,3,1,0,1,1,1,0,0,1,2,1,1,0,2,0,3,1,3
11,13,17,1,14,9,17,18,8,0,7,2,14,1,3,2,0,4,11,1,2,2,5,5,14,0,2,6,0,1,0,7,3,0,0,2,0,4,4,2,2,0,0,0,0,1,0,3,0,2,2,0,4,1,0,5,3,0,1,2,3,0,0,0,1,6,0,0,0,0,1,0,0,2,2,0,1,1,0,2,0,1,3,0,1,0,2,0,0,0,0,1,2,1,0
12,17,8,2,1,7,9,9,5,2,2,2,0,4,2,3,1,4,9,1,2,2,1,0,15,0,3,1,1,1,0,1,53,0,2,1,0,0,2,0,0,1,0,0,0,2,1,2,4,0,2,2,0,2,0,0,0,0,0,3,0,0,0,1,1,5,1,0,1,1,0,0,0,0,1,1,3,1,0,1,0,0,1,0,0,0,0,0,0,0,0,0,2,0,0
13,1,3,9,5,3,1,2,7,2,1,0,25,1,1,1,0,1,35,0,2,1,3,2,7,0,0,40,0,0,0,11,44,0,0,0,0,5,1,2,1,0,1,3,0,0,0,0,50,0,0,2,0,0,0,1,0,1,0,7,0,0,1,1,6,1,1,0,2,1,1,0,0,0,0,0,1,0,1,0,2,0,0,0,0,0,1,1,0,0,0,0,0,0,0
14,5,2,2,2,3,1,14,2,1,1,0,1,1,0,1,0,3,0,2,4,0,1,1,1,0,2,2,4,6,0,0,0,0,0,2,0,0,5,1,0,2,0,2,0,0,0,0,0,1,1,0,0,1,0,0,1,0,0,0,0,0,0,0,1,0,0,1,0,0,0,0,0,0,0,1,0,0,0,0,1,0,0,0,0,0,0,0,0,0,0,0,0,0,0
15,30,12,15,48,34,21,16,9,3,5,20,7,27,17,8,3,18,17,15,4,32,2,23,4,2,22,2,5,11,0,5,1,0,6,18,0,1,8,7,21,10,12,2,28,10,5,2,4,2,0,7,6,17,0,12,2,1,3,3,8,0,2,0,4,8,0,1,8,0,2,7,0,1,0,1,3,3,2,2,4,10,3,0,2,2,0,1,0,0,1,8,1,0,0
16,4,2,3,4,6,2,0,3,6,1,10,4,2,0,3,80,0,1,4,11,4,2,4,5,1,2,2,3,72,0,0,1,0,1,1,0,0,5,2,2,7,0,1,3,1,1,0,1,0,4,0,0,1,0,0,0,0,1,0,1,0,1,0,0,2,0,2,0,1,0,0,0,0,1,0,0,0,2,0,0,0,1,0,0,2,0,0,1,0,1,0,1,0,0
17,1,6,4,13,3,2,3,5,0,1,5,3,1,3,2,0,0,6,0,7,5,1,15,6,0,1,0,2,0,0,0,1,0,0,0,4,5,5,17,0,0,2,0,1,0,0,0,3,0,4,0,0,0,0,3,3,0,3,0,2,1,0,0,0,0,0,1,1,0,0,2,0,0,0,0,10,2,1,3,0,0,1,0,1,1,0,2,0,0,1,0,1,0,3
18,0,3,1,2,5,0,1,4,0,1,5,1,1,1,4,0,2,2,1,1,4,0,0,3,1,2,0,5,1,0,12,0,0,3,0,0,0,0,1,0,1,4,0,0,1,0,0,0,0,1,0,0,0,0,19,0,0,0,0,2,0,0,1,0,2,1,0,0,0,0,1,0,0,0,0,0,0,1,1,0,0,0,0,2,0,0,12,0,0,0,0,0,0,0
19,3,2,1,5,5,5,1,2,57,0,0,3,0,0,7,63,1,9,4,7,0,1,3,2,1,0,1,3,0,0,1,0,0,0,3,0,0,0,4,0,8,0,2,0,0,0,1,1,0,2,1,0,0,0,0,1,0,0,0,1,0,0,65,1,1,0,1,0,0,1,1,0,2,1,1,0,0,0,1,0,0,2,0,1,0,1,1,0,0,1,0,1,1,0
20,0,0,0,1,4,1,1,0,0,1,0,3,1,0,0,0,0,0,0,0,0,0,1,0,0,2,0,2,1,0,0,0,0,0,0,0,0,0,0,0,0,0,0,0,1,0,0,0,0,0,0,0,0,0,0,0,0,0,0,0,0,0,0,0,1,0,0,0,0,0,0,0,0,0,0,0,0,0,2,0,0,0,0,0,0,0,0,0,0,0,0,0,0,0
21,2,0,0,11,2,2,2,2,0,2,0,48,4,39,1,0,0,2,1,1,0,0,2,0,0,0,1,3,3,0,3,0,0,0,3,0,0,0,1,2,0,4,1,0,6,6,0,0,0,2,0,0,1,0,1,6,1,1,0,0,0,4,0,0,4,2,1,3,0,1,3,0,0,0,0,1,0,0,2,0,3,2,0,0,0,0,3,0,0,0,0,0,0,0
22,7,0,1,4,5,1,2,0,1,4,1,0,56,4,5,0,38,0,4,1,2,1,1,0,1,2,0,5,2,0,0,0,0,0,2,0,1,0,2,1,0,0,0,0,0,1,1,0,2,1,3,1,0,0,0,16,0,0,0,1,0,0,0,0,1,0,1,0,0,0,0,0,0,0,1,0,0,0,1,0,0,0,0,0,0,0,0,0,0,0,0,2,0,0
23,2,1,19,9,9,1,1,6,1,1,2,8,0,2,5,0,1,5,2,2,3,2,2,4,0,0,3,0,3,0,1,5,0,0,2,0,3,5,1,1,0,1,1,1,0,0,0,1,0,1,7,0,0,0,1,1,0,0,0,5,0,7,0,0,1,0,0,1,0,0,0,0,0,0,1,1,1,0,1,5,0,0,0,0,0,2,0,0,0,0,0,0,0,0
24,3,3,4,12,7,10,6,25,1,0,0,4,7,4,2,1,2,8,1,2,3,3,8,2,0,3,1,3,2,0,1,1,0,1,3,0,0,8,0,1,0,1,0,1,14,0,1,1,1,2,0,2,0,0,1,1,0,2,0,1,0,2,0,0,3,1,0,1,0,1,0,0,0,1,1,0,2,2,3,2,2,1,0,0,2,3,0,0,0,0,0,0,0,0
25,31,16,6,8,32,30,14,9,1,6,1,4,1,17,3,8,1,11,2,3,4,9,3,5,1,8,7,1,11,0,1,11,0,2,4,0,2,2,1,1,0,1,4,1,3,3,2,5,0,1,2,4,1,0,1,2,1,0,0,8,0,0,0,5,1,0,0,1,0,1,2,0,1,6,2,2,3,1,0,1,2,2,0,0,1,3,13,1,0,1,0,2,0,0
26,3,2,3,1,31,2,2,2,236,0,0,2,1,2,0,56,0,3,2,3,4,3,2,2,0,8,0,1,0,0,0,0,0,0,2,0,0,2,0,1,1,0,0,1,0,0,2,2,1,0,0,0,4,0,0,1,0,0,0,3,0,3,0,0,0,1,2,0,3,1,0,0,0,0,1,0,0,0,0,0,0,1,0,0,0,1,0,0,0,0,0,0,0,1
27,20,3,8,6,16,20,46,2,3,4,1,3,5,1,27,3,2,1,0,13,2,1,1,4,2,1,0,0,0,0,2,0,0,0,3,0,0,1,1,1,1,0,0,0,0,16,2,1,2,0,0,5,0,0,0,0,0,2,1,8,0,1,0,3,0,2,0,1,0,3,1,0,0,0,0,0,0,0,0,0,0,0,0,0,2,0,1,0,0,0,0,0,0,0
28,0,8,1,0,2,2,1,6,0,0,0,4,0,1,2,0,1,4,2,0,0,3,0,2,1,0,5,1,0,0,0,0,0,1,2,0,1,1,0,1,1,0,2,0,0,1,0,3,0,2,9,0,0,0,1,0,0,0,0,0,0,0,2,0,0,0,0,0,0,0,0,0,0,0,0,0,0,1,0,1,0,0,0,0,1,0,0,0,0,1,0,0,1,0
29,47,15,29,29,63,44,29,27,10,4,11,18,14,11,40,10,6,24,86,21,62,12,22,20,2,60,7,14,11,0,6,4,0,14,54,4,4,7,9,57,13,3,6,2,4,5,5,4,2,21,7,17,31,0,9,2,3,8,1,6,1,1,4,3,8,5,34,4,4,9,19,0,5,1,5,5,4,30,9,1,1,20,1,20,3,8,4,2,0,0,0,1,0,1
30,4,0,15,12,36,5,0,3,0,0,7,7,15,54,1,1,2,2,5,1,2,1,4,3,0,5,0,0,2,0,2,0,0,2,2,2,2,11,0,1,2,3,1,2,3,19,0,0,0,1,2,2,0,0,1,3,5,0,0,2,1,15,0,0,1,11,0,9,0,0,1,0,0,0,0,0,1,0,0,1,3,2,0,0,11,0,1,0,0,1,0,0,0,0
31,3,2,336,23,6,3,1,8,0,0,0,43,4,3,17,0,0,18,1,1,35,4,1,16,1,4,1,3,1,0,96,9,0,1,3,1,46,1,1,0,1,0,1,0,1,0,0,6,0,0,3,0,2,0,4,1,0,4,0,3,0,0,0,1,3,0,1,0,0,0,1,0,0,0,0,0,1,1,1,1,0,1,0,2,0,1,0,0,0,0,14,1,0,0
32,308,3,1,5,8,14,2,2,0,1,194,2,21,0,3,0,87,3,7,1,1,0,0,0,0,4,0,3,1,0,2,0,0,15,0,0,0,3,1,2,0,2,2,12,3,1,1,4,1,1,0,3,0,0,1,2,2,0,22,0,0,1,0,0,1,1,1,3,0,2,0,0,0,2,0,0,0,0,1,1,1,2,0,0,0,1,0,0,0,0,0,1,1,0
33,9,4,15,15,4,18,4,12,9,2,2,0,8,10,3,7,0,4,5,3,7,2,3,0,1,36,3,6,0,0,2,2,0,6,6,0,0,1,1,1,0,47,0,1,2,3,1,0,2,0,1,0,0,0,0,0,12,2,0,0,0,4,0,1,1,4,0,8,2,0,1,0,0,0,3,0,0,0,2,0,0,1,0,0,0,0,0,0,0,0,0,2,0,0
34,5,3,5,2,11,5,5,11,1,2,8,1,1,5,3,0,1,4,5,10,1,1,8,3,2,5,0,10,5,0,0,1,0,4,1,0,0,3,0,1,1,0,0,1,4,0,2,0,0,2,1,1,6,1,2,0,0,1,1,1,0,0,0,1,4,0,1,1,0,0,4,0,1,0,3,0,0,1,0,0,1,2,0,2,0,0,0,0,0,0,1,0,0,0
35,13,2,4,4,18,10,7,9,4,10,7,5,1,7,2,6,3,7,9,13,7,3,10,3,0,7,0,2,7,0,0,0,0,8,19,0,0,1,6,9,10,3,2,2,1,2,3,0,3,0,2,5,3,0,2,0,0,0,0,1,0,2,1,0,2,3,6,1,5,1,2,0,2,0,1,3,1,0,2,0,8,1,0,3,0,0,2,1,0,1,0,0,0,0
36,6,1,0,3,3,3,4,18,2,1,0,1,2,2,1,1,0,1,0,5,2,12,9,4,1,2,2,0,3,0,0,0,0,0,0,0,1,0,1,2,2,1,4,0,5,0,0,0,18,0,3,0,0,0,1,0,0,2,1,3,0,0,0,1,1,0,0,0,0,0,1,0,0,0,6,1,5,0,0,3,0,0,56,1,0,1,0,20,0,34,0,0,1,6
37,12,2,1,4,7,5,3,1,0,0,0,1,0,0,1,0,0,2,0,0,1,1,3,1,0,0,1,0,0,0,0,0,0,1,0,0,0,0,0,2,0,0,2,1,0,1,1,0,0,1,0,8,1,0,0,0,0,0,1,1,0,0,0,1,0,0,0,1,1,0,0,0,1,1,0,0,0,0,0,0,0,0,0,0,0,0,0,0,0,0,0,1,0,0
38,0,0,3,4,20,1,0,3,2,0,1,2,1,6,1,3,0,1,24,0,1,1,2,1,0,0,2,2,1,0,0,1,0,16,2,0,0,1,0,2,16,2,0,0,1,11,0,0,0,0,0,0,1,0,1,1,8,0,0,1,1,0,1,0,0,3,0,1,0,0,1,0,0,0,0,0,1,5,0,0,3,0,0,0,24,0,0,0,0,0,0,0,0,0
39,0,0,1,0,1,0,2,0,1,0,1,1,0,0,1,1,0,2,1,6,1,0,0,5,1,2,0,14,2,0,0,0,0,0,1,0,1,1,0,2,3,0,0,1,0,0,0,0,0,0,1,0,0,0,0,0,0,0,0,0,0,0,0,0,0,0,0,0,0,0,0,0,0,0,0,0,0,0,0,0,0,0,0,1,0,0,0,0,0,0,0,0,0,0
40,5,6,7,3,11,2,1,3,2,4,1,3,2,3,17,5,1,4,0,19,3,1,1,2,1,3,2,0,2,0,0,1,0,2,0,0,0,0,21,1,1,0,0,0,1,0,30,0,0,2,0,0,0,0,0,0,0,0,0,0,1,0,0,0,1,3,0,0,42,0,0,0,0,0,0,0,0,0,1,1,1,2,0,0,0,0,0,0,0,0,0,0,3,1
41,0,0,2,1,7,2,9,1,1,2,0,1,0,3,0,1,0,8,0,0,19,1,1,3,0,2,0,2,1,0,0,0,0,0,3,0,1,0,0,0,2,0,0,0,0,1,1,2,0,0,0,1,1,0,1,0,0,0,0,0,0,1,0,0,2,0,0,1,0,0,0,0,0,0,0,0,0,1,0,0,0,0,0,0,0,0,1,0,0,0,0,0,0,0
42,0,2,0,2,4,1,4,2,4,3,1,2,1,1,2,1,0,2,0,3,1,0,2,1,0,0,0,2,0,0,0,0,0,0,0,159,1,0,2,1,0,0,2,1,1,0,0,0,0,0,2,0,0,0,0,0,0,0,0,0,0,0,0,0,0,0,2,0,0,0,0,0,1,0,0,0,2,0,0,0,0,0,0,0,0,0,0,0,0,0,0,0,0,0
43,2,1,0,4,2,4,1,3,0,1,0,8,3,5,3,7,0,0,0,3,0,0,0,1,0,0,1,3,1,0,1,0,0,0,0,1,0,1,0,0,10,5,1,0,0,0,0,0,0,0,2,1,0,0,0,0,0,0,0,1,0,2,0,0,0,2,0,0,1,0,0,0,0,0,0,0,0,0,0,0,0,0,0,0,0,0,0,0,0,0,0,0,1,0
44,0,0,1,0,3,0,0,0,2,13,0,0,0,0,0,0,0,2,0,2,0,0,1,0,0,0,0,1,0,203,0,0,189,0,0,0,0,0,0,0,0,0,1,0,0,0,0,0,0,0,0,0,0,92,0,0,0,0,0,0,0,0,0,0,0,0,0,0,0,0,0,69,0,0,0,0,0,1,0,0,0,0,0,0,0,0,0,0,54,0,0,0,0,0
45,41,2,4,0,3,2,0,4,0,3,1,3,2,0,0,0,1,1,0,2,3,1,0,10,1,0,1,5,2,1,1,12,0,1,1,0,1,0,0,0,0,0,0,0,0,9,0,0,0,1,2,1,0,0,0,0,1,1,1,0,0,0,0,0,1,0,1,0,0,0,0,0,0,0,0,0,0,2,0,0,1,0,0,0,0,1,0,0,0,0,0,0,0,0
46,8,3,4,1,3,17,2,5,0,1,0,8,4,0,4,0,3,4,9,1,0,0,0,5,0,5,1,3,1,0,0,1,0,1,1,0,1,2,4,1,1,0,0,0,1,1,2,2,0,1,0,0,8,0,1,0,0,0,1,0,0,11,0,0,1,0,1,2,0,0,0,0,0,0,0,0,0,2,0,1,1,0,0,0,0,0,2,0,0,0,0,0,0,0
47,10,2,3,1,5,6,2,3,0,0,0,0,1,2,2,0,1,3,0,0,1,121,2,7,0,1,0,1,1,0,0,1,0,0,0,0,0,0,0,0,0,0,14,0,0,0,5,0,1,0,11,0,0,0,0,0,0,0,1,2,0,0,0,0,1,0,0,0,0,0,0,0,1,0,0,0,2,0,0,3,0,0,1,0,0,12,0,0,0,0,2,0,0,0
48,4,338,0,8,10,17,110,16,0,5,0,5,3,2,4,1,1,2,1,1,0,11,0,5,2,0,3,1,2,0,2,3,0,2,1,0,0,2,3,0,0,0,4,0,0,10,2,1,1,1,1,2,0,0,1,2,1,10,2,2,0,0,0,0,1,1,0,0,0,0,1,0,1,1,0,0,1,0,0,0,0,0,0,0,0,0,0,0,0,0,0,1,16,1
49,5,18,4,11,3,5,7,14,2,2,9,7,44,2,6,1,64,16,20,4,3,3,0,4,1,2,3,6,1,0,0,2,0,11,4,0,1,1,2,9,1,2,1,4,0,0,4,8,0,2,0,0,0,0,3,3,3,1,33,1,0,2,1,1,1,5,3,3,0,0,1,0,1,44,1,1,0,2,1,7,0,0,0,1,2,4,1,0,0,0,0,0,1,0
50,165,94,3,19,2,123,35,9,4,249,33,3,35,11,5,0,19,2,1,0,2,10,2,0,18,1,24,8,0,0,4,0,0,2,0,0,7,6,1,0,1,3,1,46,33,5,25,0,58,0,0,27,0,0,5,8,2,1,5,0,0,4,0,36,0,0,0,0,0,19,0,0,3,4,0,3,1,0,1,3,0,0,1,0,0,0,0,0,0,0,21,10,1,0
51,2,5,3,12,2,8,2,1,0,0,0,1,2,1,1,1,0,1,0,2,3,0,1,3,0,0,4,0,2,0,6,1,0,1,0,0,0,0,0,0,3,0,0,0,0,2,2,2,0,0,1,0,2,0,0,1,0,2,0,0,0,2,0,1,0,0,1,1,0,1,0,0,2,0,0,0,0,1,8,1,0,0,0,0,0,0,0,0,0,0,0,2,1,0
52,17,4,4,5,5,53,0,2,1,1,0,2,4,0,1,0,1,1,0,1,0,1,0,0,0,0,1,0,0,0,0,0,0,0,1,0,0,0,0,2,0,0,1,1,1,1,0,1,0,0,0,0,0,0,2,0,2,1,0,2,0,0,0,0,0,0,0,0,0,1,1,0,2,0,0,1,0,1,0,1,0,0,0,1,1,0,0,0,0,0,0,0,20,0
53,3,0,0,2,3,3,6,0,0,13,2,2,2,10,3,0,2,0,0,4,0,0,4,6,1,1,1,0,0,0,5,12,0,2,2,0,0,1,0,0,0,3,0,5,1,0,0,0,0,0,0,0,0,0,0,0,0,0,0,0,0,1,0,1,0,14,0,0,0,0,0,0,0,0,0,0,0,2,2,2,6,1,0,1,0,0,0,2,0,0,0,0,0,0
54,7,2,4,4,8,8,3,54,4,2,11,6,3,10,7,1,1,2,12,0,2,0,1,2,1,3,1,2,2,0,1,2,0,61,3,0,0,19,1,4,2,21,0,7,2,2,0,0,0,0,1,0,1,1,3,0,44,4,2,1,0,6,0,0,0,11,0,2,0,1,3,0,0,0,0,0,1,1,0,2,6,1,0,1,3,0,0,0,0,0,1,0,0,0
55,4,2,2,0,0,4,1,1,0,1,0,2,5,5,1,1,0,3,2,1,0,2,1,3,0,0,87,3,0,0,1,3,0,0,0,0,0,2,0,0,0,0,16,0,1,0,0,2,0,6,0,0,0,0,0,3,0,3,0,0,0,0,0,10,1,0,1,0,0,0,0,0,20,0,1,0,2,0,1,1,0,0,0,0,0,0,2,0,0,0,0,1,1,0
56,2,1,0,2,1,4,1,1,0,0,0,0,2,1,3,2,0,2,0,1,1,1,0,0,0,0,0,2,0,0,1,0,0,1,1,0,1,0,1,0,1,1,0,1,3,0,0,1,0,0,0,0,1,0,0,0,0,0,0,0,0,0,0,0,0,1,0,1,0,0,2,0,0,1,0,0,4,0,1,0,0,0,0,1,0,0,0,0,0,0,0,1,0,0
57,4,6,8,7,11,3,5,39,1,0,0,6,10,6,4,0,1,14,4,3,5,9,51,7,2,9,1,2,10,0,0,2,1,1,5,0,1,26,27,6,0,1,5,0,2,2,5,0,0,0,7,0,1,0,4,0,0,5,0,3,0,5,0,1,5,0,0,1,0,1,6,0,2,0,4,26,6,0,3,14,1,1,0,0,1,3,0,1,0,0,0,1,0,24
