LDA,0,1,2,3,4,5,6,7,8,9,10,11,12,13,14,15,16,17,18,19,20,21,22,23,24,25,26,27,28,29,30,31,32,33,34,35,36,37,38,39,40,41,42,43,44,45,46,47,48,49,50,51,52,53,54,55,56,57,58,59,60,61,62,63,64,65,66,67,68,69,70,71,72,73,74,75,76,77,78,79,80,81,82,83,84,85,86,87,88,89,90,91,92,93
0,4,4,1,2,12,2,2,0,3,3,0,2,0,0,2,1,0,0,2,5,2,1,1,1,1,0,0,19,1,0,0,2,0,1,1,0,0,2,0,3,17,0,0,1,0,0,0,0,0,0,0,0,0,0,1,1,0,2,0,0,1,0,60,0,0,0,0,0,0,1,0,0,0,0,0,0,0,0,1,0,0,0,0,0,0,1,1,0,0,0,0,0,0,0
1,9,1,0,16,2,8,4,0,0,4,3,1,2,5,1,0,0,1,1,1,1,1,0,1,0,2,1,1,1,0,2,1,0,0,2,0,0,0,0,0,1,0,0,0,2,0,3,3,0,0,1,2,1,0,0,2,0,1,1,0,0,1,0,0,0,0,0,0,0,3,1,0,0,0,0,0,0,0,0,0,0,1,0,0,0,1,0,0,0,0,0,0,0,0
2,9,2,5,3,17,12,10,7,2,1,1,0,1,0,4,0,1,4,1,4,3,1,1,6,0,1,2,0,1,0,0,0,0,1,2,0,0,0,1,1,3,0,24,0,0,2,1,2,1,7,1,1,2,0,0,3,0,0,0,1,0,1,0,1,0,0,1,0,0,0,0,0,32,0,0,0,0,0,0,0,1,0,0,0,0,3,0,1,0,0,0,2,0,0
3,7,6,13,8,5,17,4,12,0,1,1,2,1,12,4,0,1,5,9,0,10,1,1,4,2,39,3,3,0,0,4,4,0,2,2,0,0,1,1,0,0,55,0,0,2,1,1,0,3,1,1,1,0,0,0,1,18,0,0,0,76,7,0,1,1,26,0,7,0,1,0,0,0,1,0,0,1,0,2,0,0,0,0,1,2,0,1,0,0,1,0,3,2,0
4,1,0,1,0,2,1,5,0,2,0,0,1,0,2,0,0,0,3,0,1,2,0,0,0,0,0,1,2,0,0,0,0,0,1,1,0,0,0,1,1,0,0,0,0,4,0,0,0,1,0,0,0,0,0,0,10,0,0,0,0,0,1,0,0,0,0,0,1,0,0,2,0,0,0,0,0,0,0,2,0,0,0,0,0,0,0,7,0,0,0,0,0,0,0
5,1,1,0,0,2,1,2,13,16,1,0,0,5,4,3,1,1,1,3,22,0,0,2,1,106,1,1,1,0,0,0,2,0,2,1,0,0,1,1,1,9,3,2,2,2,0,0,0,1,0,0,0,2,0,1,4,0,0,0,0,0,0,3,0,0,1,0,0,0,1,0,0,0,0,0,0,0,0,1,0,4,0,0,0,0,0,0,1,0,1,0,1,0,2
6,3,17,12,10,0,7,14,8,1,12,1,3,4,18,0,0,2,3,1,0,4,9,2,0,4,1,1,0,1,0,0,0,0,0,4,0,4,2,7,1,1,7,1,7,5,3,2,0,0,0,0,1,0,0,7,3,0,3,0,6,0,1,0,2,0,0,0,1,0,1,0,0,0,1,0,4,3,0,0,3,1,0,0,1,0,0,0,0,0,2,2,3,0,0
7,6,13,4,2,27,4,14,7,1,4,8,1,22,2,3,1,9,5,10,5,3,0,2,1,1,4,1,22,2,0,14,0,0,1,1,0,1,0,0,0,1,2,0,1,1,0,3,1,3,1,0,1,0,0,0,1,0,0,9,1,0,1,0,0,0,1,2,0,0,1,0,0,1,0,0,0,1,1,1,1,0,0,0,0,1,0,0,0,0,0,0,0,4,0
8,25,10,20,19,46,20,13,16,9,6,14,8,8,7,38,6,5,15,83,21,61,8,26,23,0,56,4,21,8,0,6,3,0,13,53,2,1,5,8,67,11,1,4,3,2,3,6,4,3,13,4,10,41,0,9,2,2,4,1,8,1,2,3,3,7,5,33,1,1,4,13,0,2,0,1,3,3,36,8,2,3,23,0,28,4,6,5,1,0,0,1,2,0,1
9,197,92,9,21,4,225,27,12,0,96,40,0,52,10,1,0,33,0,1,0,0,2,0,0,12,0,17,0,0,0,2,0,0,1,0,0,4,6,0,0,0,9,0,53,13,3,8,0,30,1,0,21,0,0,5,5,8,1,7,0,0,0,0,21,0,0,0,2,0,17,0,0,3,8,0,2,0,0,0,3,1,0,1,0,1,0,0,0,0,0,18,10,2,0
10,27,80,2,7,1,22,17,6,4,118,10,6,4,4,8,1,2,0,0,1,2,13,0,1,21,0,12,0,0,0,3,0,1,0,0,0,3,1,1,0,0,0,1,6,7,2,15,0,26,0,1,12,1,0,2,3,2,1,2,0,0,1,0,14,0,0,0,0,0,9,1,0,4,0,0,1,0,0,0,1,0,0,0,0,1,0,0,0,0,0,5,4,1,0
11,0,2,3,0,6,1,7,8,0,2,0,5,1,1,2,1,1,6,1,0,5,1,0,4,1,1,1,5,0,0,0,2,0,2,0,0,0,8,8,1,0,0,0,0,0,55,1,1,1,0,0,0,1,0,1,0,3,1,0,1,0,0,0,0,0,1,0,0,1,0,0,0,0,0,0,0,0,3,0,2,0,0,0,1,9,0,0,0,0,0,0,1,3,0
12,3,2,0,2,8,4,2,12,0,0,1,2,0,0,1,0,0,1,2,2,2,18,2,4,1,2,1,5,1,0,1,0,0,0,3,0,0,1,1,3,1,0,3,0,0,0,4,1,2,0,0,0,1,0,0,0,0,0,0,0,0,1,0,0,2,0,0,0,0,1,0,0,0,0,0,0,0,0,0,0,0,1,1,1,0,0,0,0,0,2,1,0,0,0
13,2,1,29,10,2,5,1,6,0,0,1,3,1,2,17,0,0,8,0,4,3,2,12,5,0,2,0,1,4,0,2,1,0,1,3,1,6,2,3,0,1,0,2,0,0,0,0,1,0,1,22,0,1,0,1,0,0,3,0,1,0,1,1,1,1,0,0,0,0,0,0,0,0,0,1,4,0,0,2,1,0,1,0,0,0,2,0,0,0,0,4,4,0,0
14,3,4,4,1,7,0,0,4,3,1,0,4,2,7,4,2,1,1,1,4,3,2,9,1,1,4,2,0,124,0,2,1,0,1,2,0,0,0,2,1,6,0,1,1,2,1,2,0,1,2,7,0,1,0,0,0,0,1,0,2,0,2,0,0,4,1,0,0,1,0,0,0,0,0,2,3,0,1,0,0,1,1,0,0,0,0,0,0,0,0,0,5,0,0
15,9,0,1,6,2,3,4,7,2,1,0,2,0,1,0,1,1,2,2,1,2,1,2,5,0,0,1,10,0,0,1,3,0,2,0,0,8,1,2,0,0,0,1,0,3,1,1,0,0,1,1,0,0,0,1,1,0,0,0,1,1,0,1,1,1,0,0,0,0,6,0,0,2,0,2,1,0,0,0,0,1,0,0,0,0,0,3,0,0,0,1,0,0,0
16,2,3,0,2,10,0,0,4,0,0,0,0,0,1,2,1,0,2,2,1,6,0,2,2,1,4,0,6,2,0,1,2,0,0,4,0,0,1,0,1,0,0,0,0,0,0,0,1,0,0,0,2,2,0,7,0,0,0,0,0,0,0,0,0,0,0,0,0,0,0,2,0,1,0,1,0,5,0,0,0,0,1,0,1,0,0,0,0,0,0,0,1,0,0
17,3,10,1,3,61,1,3,4,0,2,1,1,0,2,0,0,0,2,1,3,2,8,1,1,0,4,3,3,1,0,1,1,0,0,1,1,1,0,0,0,1,0,22,0,0,0,0,0,3,15,0,1,0,0,0,1,0,18,0,0,0,0,1,0,1,0,1,1,0,0,0,0,0,0,1,0,13,0,0,1,1,0,0,0,1,9,0,36,0,5,0,1,0,0
18,3,2,2,1,3,0,0,0,0,0,0,3,0,1,0,1,0,0,0,2,1,0,1,0,0,0,0,1,0,0,0,0,0,1,1,1,0,0,1,1,0,0,0,0,0,0,0,0,0,0,0,0,0,0,0,1,0,0,0,1,0,0,0,0,1,0,0,1,0,0,0,0,0,0,0,0,0,1,0,0,0,0,0,0,0,0,0,0,0,0,0,0,0,0
19,4,4,0,5,19,4,2,8,1,2,0,3,1,6,1,1,0,2,2,2,1,1,12,1,1,4,8,5,3,0,0,0,0,1,2,0,2,1,1,1,7,0,3,1,2,4,0,1,1,0,0,3,2,0,0,0,0,0,0,4,1,0,1,17,1,0,2,12,0,1,2,0,0,0,0,0,2,0,1,0,0,0,1,0,0,0,0,0,0,0,0,0,0,0
20,1,1,8,1,12,2,2,4,1,1,1,7,0,0,1,0,0,6,0,1,0,0,1,2,1,0,1,2,0,1,0,1,0,0,1,0,1,0,0,0,1,0,16,1,0,0,2,3,0,3,0,0,0,0,0,0,0,2,1,1,0,0,1,1,0,0,0,0,0,0,0,0,1,0,1,0,1,1,0,1,0,0,0,0,0,7,1,1,0,0,0,0,0,0
21,0,1,0,3,6,1,2,7,0,0,0,0,1,1,2,1,0,1,2,3,3,1,2,1,0,0,1,4,1,0,0,1,0,0,0,0,0,1,1,0,0,0,2,0,0,0,0,0,0,0,2,0,0,0,0,0,0,1,0,1,0,1,0,0,0,0,0,0,0,0,1,0,0,0,10,0,4,0,1,1,0,0,0,1,0,0,0,0,0,1,0,0,0,1
22,4,0,11,6,0,3,0,5,0,1,3,15,1,91,0,2,1,4,11,0,0,0,5,4,0,1,2,0,4,0,1,0,0,17,3,0,0,2,1,1,1,7,0,1,7,6,0,1,0,0,0,0,0,1,3,1,16,1,0,0,1,12,1,0,3,13,1,9,0,1,1,0,0,1,0,1,0,0,2,1,7,1,0,0,13,0,1,0,0,0,0,1,1,0
23,8,7,1,4,8,4,5,0,0,2,0,3,41,3,1,0,45,11,1,2,1,1,0,2,0,5,3,0,0,0,4,1,0,0,2,0,2,2,0,0,5,0,0,1,0,1,0,0,0,0,1,1,1,0,3,2,0,0,0,5,0,0,1,0,1,1,0,1,0,0,1,0,0,0,0,0,0,0,0,0,1,0,0,0,0,0,0,0,0,0,0,1,0,0
24,5,6,4,3,31,7,5,11,0,0,3,14,7,3,8,0,2,5,3,2,7,3,9,7,3,2,3,4,2,0,1,2,0,2,3,0,0,34,11,1,1,1,2,1,2,8,4,1,2,2,1,0,1,0,1,4,2,3,0,13,0,18,0,1,0,9,2,3,0,0,12,0,0,0,0,1,0,1,13,2,5,1,0,1,3,3,1,0,0,0,1,0,0,0
25,26,7,3,10,24,29,28,4,3,7,3,2,7,7,1,1,1,20,7,3,5,5,6,3,0,8,1,0,2,0,2,0,0,1,7,1,1,2,3,4,1,5,1,1,2,3,2,0,0,1,1,5,3,0,5,0,2,1,2,3,0,0,0,1,2,1,3,3,4,3,1,0,1,0,0,3,2,3,1,0,0,2,0,0,0,2,0,0,0,0,1,0,0,0
26,11,0,1,0,3,3,0,0,1,1,0,1,0,0,3,0,1,3,1,6,2,0,0,0,0,1,0,1,0,0,1,0,0,0,0,0,0,0,1,2,1,0,1,0,0,0,0,1,0,1,0,0,0,0,0,0,0,0,0,0,0,0,0,0,0,0,0,0,0,1,0,0,0,0,0,0,0,1,0,0,0,0,0,0,0,0,0,0,0,0,0,0,0,0
27,4,3,2,3,7,2,3,2,0,2,6,2,3,2,2,0,0,4,3,0,1,1,2,6,0,2,1,4,0,0,3,0,0,2,3,0,0,0,0,5,1,0,0,1,1,1,0,1,0,2,0,0,0,0,2,0,0,0,0,0,0,1,1,0,3,1,1,0,0,0,2,0,0,1,0,0,0,1,0,1,2,0,0,0,2,0,12,0,0,0,0,1,0,0
28,0,1,3,1,2,0,2,2,1,1,1,15,0,1,0,1,0,1,7,2,1,1,1,1,1,1,1,5,1,0,1,0,0,1,2,0,1,1,0,4,0,0,0,3,0,0,1,0,0,0,0,0,0,0,0,0,0,0,0,0,0,0,0,0,0,0,2,0,0,1,0,0,0,0,0,0,0,1,0,0,0,0,0,1,1,0,0,0,0,0,0,0,1,0
29,0,3,0,1,1,1,2,1,1,1,4,1,0,0,0,5,1,1,0,9,0,2,1,1,0,0,0,2,0,0,1,0,0,0,1,0,1,0,0,0,5,0,0,0,0,0,0,1,0,0,0,0,1,0,2,0,0,0,0,1,0,0,1,0,0,1,0,1,1,0,0,0,0,0,0,0,0,0,0,0,0,0,0,0,0,0,0,0,0,0,0,0,1,0
30,2,1,4,1,7,1,0,0,0,0,0,3,0,1,3,1,1,4,2,7,22,0,1,14,1,0,0,4,2,1,48,1,0,0,1,0,0,0,0,0,0,0,0,0,0,0,0,0,0,0,3,0,0,0,1,0,0,1,0,0,0,0,0,0,4,0,0,0,0,0,0,0,0,0,0,0,0,0,2,0,2,1,0,1,0,0,0,0,0,0,1,1,0,0
31,1,3,7,269,7,1,0,3,0,0,0,3,2,3,22,0,2,7,0,0,4,0,1,2,0,4,0,0,0,0,2,0,0,2,3,0,7,0,2,9,0,1,0,1,0,0,0,0,0,1,0,0,0,0,4,0,0,1,0,1,0,0,0,0,7,0,0,0,0,0,1,0,16,0,0,0,2,1,0,2,0,0,0,5,0,0,0,0,0,0,0,0,0,0
32,5,1,4,4,5,2,10,3,1,1,0,1,0,1,0,1,1,3,0,6,2,0,0,6,0,0,0,2,2,0,7,1,0,0,2,0,0,2,0,0,1,0,2,0,0,1,0,5,0,0,3,1,1,0,1,0,0,0,1,2,0,0,0,0,1,0,1,0,0,2,1,0,1,0,2,0,1,0,4,1,1,0,0,0,0,0,1,0,0,0,0,1,0,0
33,4,2,4,4,7,1,2,3,0,1,1,3,1,2,3,4,1,2,11,2,19,0,4,4,0,6,0,0,1,0,2,0,0,0,1,0,1,0,1,4,7,0,1,0,1,1,0,0,0,1,1,2,2,0,0,0,0,0,0,0,0,0,0,0,2,0,2,1,0,1,2,0,0,0,0,0,0,0,0,1,0,1,0,0,0,0,0,0,0,0,0,0,0,0
34,3,10,5,3,2,2,7,8,1,2,0,8,6,4,3,0,2,4,4,2,3,5,24,2,0,7,1,10,9,0,7,3,0,3,3,0,1,3,2,1,2,1,1,1,1,2,0,4,3,0,6,4,0,0,1,0,0,5,2,4,0,2,0,1,1,0,1,0,1,2,4,0,0,0,2,4,5,1,0,0,0,4,0,1,0,1,1,0,0,0,0,2,0,0
35,4,2,3,4,8,5,8,3,3,2,0,5,2,4,4,2,2,4,2,1,3,0,4,7,1,3,0,0,7,0,19,0,0,3,2,1,0,6,1,2,2,1,0,1,2,0,0,2,1,1,0,2,2,0,0,0,0,0,0,1,0,0,0,0,1,1,1,1,0,2,1,0,0,0,0,0,0,1,0,0,0,0,0,1,0,0,0,0,0,0,0,1,0,0
36,14,1,1,1,2,10,0,0,0,4,1,1,0,0,0,1,0,0,2,1,2,0,0,0,0,0,0,1,2,0,0,1,0,1,1,0,0,0,1,0,0,0,0,0,0,0,1,1,0,1,0,0,0,0,0,0,1,0,0,0,0,0,0,0,0,0,0,0,0,0,0,0,0,0,0,0,0,0,1,0,0,0,0,0,0,0,1,0,0,0,0,0,0,0
37,9,3,1,0,5,8,6,3,1,0,2,4,5,2,1,0,0,0,1,0,3,1,3,2,0,5,1,1,0,0,1,1,0,2,1,0,0,0,0,0,1,0,1,0,0,0,0,1,0,0,0,11,5,0,0,0,15,0,0,1,0,0,0,1,1,0,1,0,0,1,0,0,0,1,1,0,1,0,1,1,0,0,0,0,1,0,0,0,0,0,0,2,0,0
38,0,0,210,3,3,1,1,5,0,0,7,8,3,2,4,0,0,3,1,1,6,4,0,1,0,8,1,0,1,0,6,2,0,2,3,5,8,1,0,1,3,2,0,4,0,0,1,0,0,1,1,0,0,0,0,1,1,0,0,0,0,1,0,0,0,0,6,0,0,0,2,0,1,1,0,0,0,0,1,1,2,0,0,0,1,0,1,0,0,0,2,0,0,0
39,9,2,1,0,2,1,3,7,0,1,2,1,1,0,0,0,2,0,0,2,0,0,0,0,0,0,0,0,1,0,0,0,0,2,1,0,0,1,0,1,0,1,0,0,0,1,0,1,0,0,0,0,7,0,0,1,0,0,1,1,0,0,0,0,0,0,0,0,1,0,1,0,1,0,0,0,0,1,0,0,0,0,0,0,0,0,0,0,0,0,0,1,1,0
40,3,16,4,3,4,24,9,18,1,3,0,7,6,0,13,5,1,0,1,1,0,11,14,9,2,2,5,1,5,0,0,1,0,1,2,0,1,2,2,1,2,1,13,2,6,0,41,0,19,1,4,1,0,0,1,1,0,2,0,3,1,0,0,1,2,0,0,0,0,0,1,0,0,0,14,2,4,0,1,5,1,0,56,1,0,2,0,5,0,34,0,0,27,2
41,4,0,1,0,1,2,1,0,7,6,0,1,1,1,4,5,0,1,3,3,0,0,0,0,58,1,104,2,0,0,2,1,0,0,1,0,1,0,1,1,3,0,1,0,1,0,1,0,1,0,0,4,0,0,0,2,0,1,0,0,0,0,0,3,0,0,0,0,0,3,0,0,0,0,1,0,0,1,0,0,0,0,0,0,0,0,1,1,0,0,0,0,1,0
42,2,0,7,7,2,0,0,2,0,1,0,52,0,3,0,0,0,2,1,0,0,0,0,1,0,0,0,1,0,0,0,0,0,1,3,0,1,0,1,1,0,1,0,0,1,1,0,0,0,0,1,0,0,0,1,1,0,1,0,0,0,0,1,0,0,0,0,2,0,0,0,0,0,0,0,0,0,1,0,0,0,1,0,0,0,0,0,0,0,0,0,0,0,0
43,1,1,2,0,3,2,1,8,1,2,0,6,1,1,2,1,0,2,1,4,0,5,5,4,0,1,0,2,1,0,2,0,0,0,0,0,2,0,1,0,10,0,0,0,0,0,0,1,0,27,1,1,0,0,0,0,0,1,0,0,0,1,2,0,3,1,0,0,0,1,1,0,0,0,17,1,2,0,0,0,0,4,0,0,0,1,0,3,0,1,0,2,1,2
44,1,2,2,4,6,1,2,2,0,1,0,1,0,1,0,0,0,2,4,0,3,2,3,2,1,3,0,5,0,0,1,0,0,1,0,1,0,1,2,2,2,0,0,0,1,1,0,4,0,0,1,1,1,0,0,2,0,3,0,0,0,1,0,0,2,1,0,0,0,0,0,0,1,0,0,0,2,0,0,0,0,0,0,2,0,0,0,0,0,0,0,0,0,0
45,1,3,1,4,25,2,1,1,0,0,0,2,2,2,1,1,1,1,1,1,0,1,1,0,0,4,1,0,0,0,0,0,0,2,0,0,1,3,3,1,1,7,0,1,0,0,0,0,0,2,0,0,0,0,0,1,4,0,0,0,0,4,0,0,0,0,1,0,0,0,0,0,0,0,0,0,0,0,0,0,0,0,0,0,0,1,2,0,0,0,0,0,0,0
46,0,0,0,0,0,0,0,0,1,0,0,0,1,0,0,0,0,0,1,1,1,0,0,0,0,0,0,0,1,0,0,0,0,0,0,0,0,0,0,1,0,0,0,1,0,0,0,0,0,0,0,0,0,0,0,0,0,0,0,0,0,0,0,0,0,0,0,0,0,0,0,0,0,0,0,0,0,0,0,0,0,0,0,0,0,0,0,0,0,0,0,0,0,0
47,5,46,8,2,1,0,1,1,0,1,1,0,0,4,1,1,1,7,2,4,2,2,3,3,0,1,0,0,2,0,1,2,0,0,1,0,0,0,0,0,0,0,1,1,0,1,0,0,0,1,3,3,0,0,1,0,0,1,1,1,0,0,0,1,2,0,0,1,0,0,0,0,0,0,0,0,0,0,2,0,0,0,0,0,0,4,1,0,0,0,0,0,3,0
48,5,0,2,3,2,1,6,1,0,28,1,3,18,1,2,0,12,7,3,0,0,0,0,1,0,2,5,4,0,0,2,1,0,1,4,0,1,0,0,1,0,0,1,3,1,0,1,1,0,0,0,0,1,0,0,20,0,0,1,0,0,0,0,0,2,1,0,1,1,0,0,0,0,0,0,0,0,0,0,0,0,0,0,0,0,0,0,0,0,0,0,0,1,0
49,4,0,1,1,2,2,0,10,1,2,2,0,1,2,2,8,0,2,2,3,1,3,4,0,0,1,0,2,1,0,0,1,0,1,2,0,1,4,1,0,2,4,1,0,8,0,0,0,0,2,0,1,0,0,15,0,2,0,0,0,0,0,0,0,0,0,1,1,1,0,1,0,0,0,0,1,0,0,0,0,0,0,0,0,0,0,0,0,0,0,0,0,0,1
50,4,0,1,0,6,2,1,6,3,0,26,0,1,0,6,0,1,0,23,6,2,0,1,0,0,3,0,7,1,0,0,0,0,50,1,0,0,4,1,1,4,0,0,12,0,0,0,0,0,0,1,0,3,0,1,0,3,1,0,3,0,1,1,0,0,0,1,1,0,0,0,0,0,0,0,0,0,1,0,0,0,0,0,0,1,0,1,0,1,0,0,0,0,0
51,5,5,5,2,7,4,4,9,0,0,7,2,13,4,1,3,19,32,2,1,3,8,1,38,0,2,1,8,1,0,8,100,0,2,7,0,0,4,0,1,1,0,6,1,0,0,0,9,1,1,2,1,2,0,0,3,2,0,1,0,0,0,0,0,4,1,1,4,0,0,0,0,0,1,1,0,0,0,1,4,11,0,0,1,1,2,3,0,0,0,0,0,0,0
52,0,4,1,0,5,0,1,2,0,0,0,3,0,15,6,0,0,2,3,1,2,0,1,1,0,1,0,0,4,0,2,1,0,0,1,0,1,0,1,3,0,1,0,0,0,0,0,0,0,0,2,0,1,0,0,0,0,3,0,3,0,2,0,0,3,0,0,0,1,0,1,0,0,0,0,0,0,1,0,0,3,1,0,1,0,0,1,1,0,0,0,0,0,0
53,1,1,0,0,1,1,1,0,318,0,0,0,0,1,7,189,0,2,1,8,1,75,0,0,1,0,0,1,0,0,0,1,0,0,0,0,0,0,5,0,2,0,4,0,0,0,1,4,0,3,0,0,0,0,0,0,0,0,0,0,0,0,0,0,0,0,1,1,2,0,0,0,0,0,0,0,0,0,0,1,0,2,0,0,0,1,0,0,0,1,0,0,1,0
54,1,0,1,0,1,1,0,4,0,0,1,1,0,1,6,2,0,1,3,1,1,0,2,1,0,0,0,6,1,0,2,0,0,0,3,0,0,4,1,1,0,1,1,0,0,0,0,0,0,0,0,0,1,0,0,0,0,1,0,1,0,0,0,1,0,0,0,1,0,0,0,0,0,0,0,0,1,1,0,0,0,0,0,0,0,0,0,0,0,0,0,0,0,1
55,5,10,9,5,8,4,96,12,0,2,0,38,2,1,2,2,0,27,0,0,0,7,1,10,0,0,26,1,0,0,16,31,0,0,2,0,5,3,2,0,0,0,1,0,1,0,1,50,0,3,4,0,0,0,2,2,0,3,5,1,0,1,0,6,2,0,0,2,0,0,0,0,1,0,0,2,0,1,2,4,1,0,0,1,0,3,1,0,0,0,0,0,0,0
56,343,3,4,2,1,3,3,0,0,2,188,1,5,1,4,0,83,0,4,1,1,0,0,1,0,1,1,0,0,0,0,0,0,31,0,0,0,0,0,2,1,3,0,5,0,0,2,0,1,0,0,0,0,0,2,1,5,0,48,0,1,3,0,0,0,2,2,1,0,4,2,0,0,51,0,0,1,1,1,2,1,0,0,0,5,0,3,0,0,0,1,0,0,0
57,2,40,1,0,5,3,7,30,0,2,0,2,10,1,3,0,1,0,2,0,0,4,1,9,3,0,0,0,1,0,0,0,0,1,1,0,0,5,0,0,0,1,0,1,21,2,3,0,2,0,2,1,0,0,1,0,1,1,1,0,0,1,0,0,1,2,0,1,1,0,0,0,0,0,0,0,0,1,1,1,2,0,0,0,0,1,0,0,0,0,1,2,0,0
58,4,0,2,3,0,4,0,3,0,1,1,1,1,0,2,1,0,2,1,1,1,0,2,0,0,1,0,0,2,0,1,0,0,1,2,0,1,1,2,0,0,1,0,1,1,0,0,0,0,1,0,0,1,0,0,0,0,0,0,0,0,0,0,0,0,0,1,0,0,0,2,0,0,0,0,0,0,0,1,0,0,2,0,0,0,0,0,0,0,1,0,0,0,0
59,1,3,0,2,0,1,0,3,0,0,0,0,0,0,3,0,0,3,0,4,1,0,1,1,0,0,0,0,0,0,0,0,0,0,0,159,0,0,1,0,0,0,1,0,0,0,0,0,0,0,2,0,0,0,0,0,0,1,0,0,0,0,0,0,1,0,0,0,0,0,0,0,0,0,0,0,1,0,0,0,1,0,0,0,0,0,0,1,0,0,1,0,0,0
60,0,3,0,2,4,1,3,5,2,1,0,0,0,0,33,4,0,2,1,55,1,1,1,1,4,1,2,0,1,0,1,0,0,1,0,1,0,2,12,1,2,0,0,0,0,0,1,0,0,0,0,0,0,0,1,0,0,1,0,0,0,0,0,0,0,0,0,0,53,0,0,0,0,1,0,0,0,0,0,0,0,0,0,1,0,1,0,1,0,1,0,0,1,0
61,7,75,4,3,6,3,3,2,0,1,0,6,2,3,0,0,2,6,0,1,2,6,3,5,1,5,1,2,0,0,2,2,0,3,5,0,0,2,2,0,1,0,2,0,0,2,0,1,0,1,2,0,1,0,0,0,0,4,0,5,0,0,0,2,4,0,0,0,0,1,0,0,0,0,0,0,0,1,2,3,1,0,0,1,1,1,0,0,0,0,0,0,0,0
62,3,35,78,29,4,0,1,3,0,4,0,6,26,9,18,0,2,1,3,0,1,0,1,1,0,0,1,6,0,0,6,1,0,1,1,0,89,1,0,1,1,9,0,0,2,1,1,0,0,1,1,0,0,0,2,2,0,0,1,0,0,1,0,1,0,1,0,8,1,0,0,0,0,0,0,2,1,0,0,0,0,0,0,4,0,0,2,0,0,0,11,0,0,0
63,17,2,15,6,2,41,1,0,0,2,16,3,10,4,8,0,0,1,10,1,2,0,0,0,1,4,1,2,0,0,0,0,0,5,0,0,5,1,2,2,0,2,0,11,2,0,0,0,0,0,2,2,2,0,2,0,0,0,0,0,0,0,0,0,0,1,0,0,0,1,4,0,0,0,0,0,0,0,1,0,1,0,0,0,6,0,1,0,0,0,1,0,0,0
64,1,3,9,6,5,3,5,30,0,0,1,7,3,2,5,0,0,7,2,13,3,10,24,6,1,2,0,1,2,0,3,1,0,4,1,0,3,18,36,0,1,0,1,1,2,2,0,0,0,0,2,1,0,0,0,0,0,6,0,1,0,3,2,0,1,0,1,2,1,0,1,0,0,0,1,31,4,0,1,16,1,1,0,0,0,3,0,1,0,0,0,0,0,2
65,1,2,3,2,5,2,1,1,2,3,0,2,1,3,2,24,1,2,6,7,2,0,6,2,1,3,0,6,0,0,0,0,0,0,5,0,0,1,1,2,8,1,1,0,1,1,1,1,0,0,0,0,2,0,0,0,1,0,0,2,1,0,3,0,1,1,2,0,0,0,1,0,1,0,0,0,2,2,2,0,2,0,0,0,0,0,0,0,0,0,0,0,0,0
66,5,7,2,1,14,1,3,5,0,2,0,7,1,3,0,0,1,11,1,0,3,1,1,1,0,0,1,1,0,0,2,8,0,2,0,0,1,0,0,0,0,7,0,0,2,0,0,2,0,0,0,0,0,0,0,0,0,0,3,2,0,2,0,0,1,2,0,1,0,0,0,0,0,1,1,0,0,1,0,1,0,3,0,0,2,0,0,0,0,0,0,0,0,0
67,0,0,0,0,0,0,0,0,0,0,0,1,0,0,0,0,0,1,0,1,0,0,1,0,0,0,0,0,0,0,0,0,187,0,0,0,0,0,1,0,1,0,0,0,0,1,0,0,0,0,0,0,0,89,1,0,0,0,0,0,0,0,0,0,0,0,0,0,0,0,0,0,0,0,0,0,0,0,0,0,0,0,0,2,0,0,0,0,0,0,0,0,0,0
68,3,2,3,3,3,1,5,3,0,0,0,3,19,1,0,0,33,0,0,0,4,1,5,1,1,0,0,0,1,0,0,0,0,0,0,0,0,0,0,1,0,0,0,0,0,0,1,0,0,1,3,0,1,0,0,4,0,2,0,0,0,1,0,0,0,0,0,0,0,0,0,0,0,0,3,1,0,0,0,1,1,0,0,0,0,0,0,1,0,0,0,1,0,0
69,12,1,13,15,7,4,2,18,7,4,0,3,2,6,1,5,2,7,3,2,3,1,6,3,0,3,3,4,4,0,0,1,0,1,0,0,2,3,1,0,9,0,3,0,4,0,1,0,0,1,3,1,0,0,0,0,1,1,0,1,0,0,0,2,1,0,0,0,1,0,0,0,0,0,0,0,1,1,1,0,0,1,0,0,1,0,0,0,0,0,1,0,0,0
70,3,3,2,3,9,2,4,21,1,1,0,17,2,4,3,0,0,3,0,2,8,3,9,4,0,9,0,0,0,0,1,1,0,3,6,0,0,3,5,5,0,0,2,0,1,2,1,1,0,0,1,0,1,0,2,0,0,0,0,2,0,11,0,1,3,0,0,0,0,0,1,0,0,0,1,0,1,0,2,0,2,5,0,0,0,0,0,0,0,1,0,0,0,0
71,0,0,1,0,2,0,0,0,0,19,0,0,0,0,0,0,0,1,0,3,0,0,0,0,0,0,0,2,0,202,0,0,2,0,0,0,0,0,0,0,1,0,1,0,0,0,0,0,0,0,0,0,0,3,0,0,0,0,0,0,0,0,0,0,1,0,0,0,0,0,0,69,0,0,0,0,0,0,1,0,0,0,0,0,0,0,0,0,54,0,0,0,0,0
72,6,49,0,2,4,0,32,3,0,4,2,0,1,0,4,0,1,1,0,1,0,5,4,0,0,0,1,1,1,0,0,1,0,0,1,0,0,0,0,0,1,0,0,0,1,5,0,0,1,3,2,0,0,0,0,2,0,6,0,0,2,0,0,0,0,1,0,0,0,0,0,0,0,0,0,0,2,0,0,0,0,0,1,0,0,0,0,0,0,2,0,0,0,0
73,5,0,5,4,17,6,11,3,3,2,4,2,1,3,1,1,2,1,3,1,5,3,0,0,0,5,1,5,1,0,0,0,0,3,3,0,0,1,0,3,1,1,2,0,0,0,0,2,1,0,2,2,0,0,0,1,0,0,0,3,0,0,0,0,3,3,1,1,0,0,4,0,0,0,3,1,1,0,0,0,1,0,0,1,1,1,2,0,0,1,0,0,0,0
74,4,8,1,2,6,1,5,4,1,2,0,2,1,2,1,0,1,2,0,1,4,4,5,3,0,0,1,1,1,0,1,1,0,0,0,0,2,2,2,0,0,0,0,0,2,0,0,0,0,1,2,0,0,1,1,0,0,0,1,1,0,0,0,0,0,0,2,0,0,1,1,0,0,0,2,0,0,0,1,0,0,3,0,0,0,1,2,1,0,0,0,0,0,38
